02,0,0-02,0,0-02,0,0-02,0,0-02,0,0-02,0,0-02,0,0-02,0,0-02,0,0-02,0,0-02,0,0-02,0,0-02,0,0-02,0,0-02,0,0-02,0,0-02,0,0-02,0,0-02,0,0-02,0,0-02,0,0-02,0,0-02,0,0-02,0,0-02,0,0-02,0,0-02,0,0-02,0,0-02,0,0-02,0,0-02,0,0-02,0,0-02,0,0-02,0,0-01,4,0
02,0,0-01,0,0-01,0,0-03,0,1-00,0,0-00,0,0-01,0,0-02,0,0-01,0,0-01,0,0-01,3,0-01,0,0-01,0,0-01,0,0-01,0,0-01,3,0-00,0,0-00,0,0-01,2,0-03,0,3-01,0,0-01,0,0-01,0,0-01,0,0-01,2,0-03,2,1-01,0,0-01,0,0-01,0,0-01,4,0-02,0,0-02,0,0-02,0,0-02,0,0-01,3,0
02,0,0-01,0,0-01,0,0-01,2,0-00,0,0-00,0,0-01,0,0-01,3,0-01,0,0-01,0,0-03,0,1-01,0,0-01,0,0-01,0,0-01,0,0-01,3,0-01,2,0-01,2,0-01,2,0-00,0,0-00,0,0-01,0,0-01,0,0-03,2,3-01,2,0-01,0,0-01,0,0-01,0,0-01,0,0-01,0,0-01,0,0-01,0,0-00,0,0-00,0,0-01,4,0
02,0,0-01,0,0-01,0,0-01,2,0-00,0,0-01,0,0-01,0,0-03,0,1-01,0,0-01,0,0-02,0,0-01,3,0-01,3,0-01,3,0-03,0,2-01,3,0-01,2,0-01,2,0-01,2,0-00,0,0-00,0,0-01,0,0-01,0,0-01,0,0-01,2,0-03,0,3-01,0,0-01,0,0-01,0,0-01,0,0-01,0,0-01,0,0-01,0,0-00,0,0-01,2,0
02,0,0-01,0,0-01,0,0-01,2,0-01,3,0-03,0,0-01,2,0-01,3,0-01,0,0-01,0,0-04,0,1-00,0,0-01,3,0-02,0,0-00,0,0-01,0,0-03,0,1-00,0,0-01,2,0-00,0,0-03,0,3-01,0,0-01,0,0-01,0,0-02,0,0-01,0,0-01,0,0-01,0,0-01,0,0-01,0,0-00,0,0-00,0,0-01,0,0-00,0,0-01,4,0
02,0,0-01,0,0-01,0,0-01,2,0-01,0,0-01,0,0-01,2,0-01,3,0-01,3,0-01,3,0-01,3,0-00,0,0-01,0,0-01,0,0-01,0,0-01,0,0-03,0,1-00,0,0-01,2,0-00,0,0-03,0,3-01,0,0-01,0,0-01,0,0-01,0,0-01,0,0-01,0,0-01,0,0-01,0,0-01,0,0-02,0,0-00,0,0-01,0,0-01,0,0-01,2,0
02,0,0-00,0,0-01,0,0-03,0,0-01,0,0-01,0,0-01,2,0-00,0,0-00,0,0-00,0,0-00,0,0-00,0,0-01,0,0-01,0,0-01,0,0-01,0,0-03,0,1-00,0,0-01,2,0-00,0,0-03,0,3-01,0,0-01,0,0-01,0,0-01,0,0-01,0,0-01,0,0-01,0,0-01,0,0-03,4,0-01,4,0-00,0,0-01,0,0-01,0,0-01,2,0
02,0,0-00,0,0-01,0,0-01,0,0-01,0,0-00,0,0-01,2,0-01,2,0-01,2,0-01,2,0-01,2,0-01,0,0-01,0,0-01,0,0-01,2,0-01,0,0-03,0,1-00,0,0-01,2,0-00,0,0-03,0,3-01,0,0-01,0,0-01,0,0-01,0,0-01,0,0-01,4,0-01,4,0-01,4,0-01,4,0-01,4,0-00,0,0-01,0,0-01,0,0-01,4,0
02,0,0-00,0,0-01,0,0-01,0,0-01,0,0-01,0,0-01,0,0-01,0,0-01,0,0-03,0,1-01,2,0-01,0,0-03,0,2-01,0,0-01,2,0-01,0,0-02,0,0-01,0,0-03,0,0-01,0,0-02,0,0-03,0,2-01,0,0-01,0,0-01,0,0-01,0,0-01,4,0-00,0,0-00,0,0-00,0,0-00,0,0-00,0,0-01,0,0-01,0,0-01,3,0
02,0,0-02,0,0-01,2,0-03,0,3-01,0,0-01,0,0-01,0,0-01,0,0-01,0,0-03,0,1-01,2,0-01,2,0-01,2,0-01,2,0-01,2,0-01,0,0-01,0,0-01,0,0-01,0,0-01,0,0-01,0,0-01,2,0-01,0,0-01,0,0-01,0,0-01,0,0-01,4,0-00,0,0-01,0,0-01,0,0-01,0,0-01,0,0-01,0,0-01,0,0-01,2,0
02,0,0-02,0,0-01,2,0-01,0,0-01,0,0-01,0,0-03,0,2-01,0,0-01,0,0-03,0,1-01,2,0-01,0,0-03,0,0-01,0,0-01,2,0-03,0,3-01,0,0-01,0,0-00,0,0-01,0,0-01,0,0-00,0,0-01,0,0-01,0,0-01,0,0-01,0,0-01,4,0-00,0,0-04,0,3-01,0,0-01,0,0-01,0,0-01,0,0-01,0,0-01,2,0
02,0,0-02,0,0-01,2,0-01,0,0-01,0,0-01,0,0-01,0,0-01,0,0-01,0,0-01,0,0-01,0,0-01,0,0-01,0,0-01,0,0-01,0,0-01,0,0-01,0,0-01,0,0-04,0,1-01,0,0-01,0,0-04,0,3-01,0,0-03,4,3-01,4,0-01,4,0-01,4,0-00,0,0-01,0,0-01,0,0-03,2,0-01,0,0-01,0,0-01,0,0-01,2,0
02,0,0-01,3,0-01,2,0-01,3,0-02,0,0-01,0,0-01,0,0-01,0,0-01,0,0-01,0,0-01,0,0-01,0,0-01,0,0-01,0,0-01,0,0-01,0,0-01,0,0-01,0,0-00,0,0-01,0,0-01,0,0-00,0,0-01,0,0-01,0,0-01,0,0-01,0,0-01,4,0-00,0,0-01,0,0-01,0,0-01,2,0-01,0,0-01,0,0-01,3,0-01,3,0
02,0,0-02,0,0-01,2,0-01,2,0-01,3,0-01,0,0-04,0,2-01,0,0-01,0,0-01,2,0-01,2,0-02,0,0-01,0,0-01,0,0-02,0,0-02,0,0-01,0,0-01,0,0-04,0,1-01,0,0-01,0,0-04,0,3-01,0,0-01,0,0-01,0,0-01,0,0-01,4,0-00,0,0-00,0,0-00,0,0-01,2,0-01,0,0-01,0,0-01,0,0-01,3,0
02,0,0-02,0,0-02,0,0-01,2,0-01,2,0-01,2,0-01,2,0-01,2,0-01,2,0-01,2,0-01,2,0-01,4,0-01,0,0-01,0,0-01,0,0-01,0,0-01,0,0-01,0,0-00,0,0-01,0,0-01,0,0-01,0,0-01,0,0-01,0,0-01,0,0-01,0,0-01,4,0-03,2,3-01,2,0-01,2,0-01,2,0-01,2,0-01,0,0-01,0,0-01,4,0
02,0,0-02,0,0-01,2,0-01,2,0-01,3,0-01,3,0-01,3,0-01,3,0-01,0,0-01,2,0-01,2,0-01,4,0-01,0,0-01,0,0-02,0,0-01,2,0-00,0,0-00,0,0-00,0,0-00,0,0-03,0,3-01,0,0-01,0,0-01,0,0-01,0,0-01,0,0-01,4,0-01,0,0-01,0,0-01,0,0-01,2,0-01,0,0-01,0,0-01,0,0-01,3,0
02,0,0-01,2,0-01,2,0-01,0,0-01,0,0-01,0,0-01,3,0-01,0,0-01,0,0-01,0,0-01,0,0-01,0,0-01,0,0-01,0,0-01,2,0-01,2,0-00,0,0-00,0,0-00,0,0-03,0,3-01,0,0-01,0,0-03,0,1-01,2,0-01,2,0-03,2,1-01,4,0-02,0,0-01,0,0-01,0,0-01,2,0-01,0,0-01,3,0-01,3,0-01,3,0
02,0,0-01,2,0-01,0,0-01,0,0-01,0,0-01,0,0-01,3,0-01,0,0-01,0,0-01,0,0-01,0,0-01,0,0-01,0,0-01,0,0-02,0,0-01,2,0-00,0,0-00,0,0-03,0,3-01,0,0-01,0,0-01,2,0-01,2,0-01,2,0-01,2,0-01,2,0-01,0,0-01,0,0-01,0,0-01,0,0-03,0,0-01,0,0-01,0,0-01,0,0-01,3,0
02,0,0-01,2,0-01,3,0-01,0,0-03,0,2-01,0,0-01,0,0-01,0,0-01,0,0-01,0,0-01,0,0-01,0,0-04,0,2-01,0,0-01,0,0-01,2,0-01,2,0-01,2,0-01,0,0-01,0,0-01,0,0-01,2,0-03,0,3-01,0,0-03,0,1-01,2,0-01,0,0-01,0,0-01,0,0-01,0,0-01,0,0-01,0,0-01,0,0-01,0,0-01,3,0
02,0,0-01,2,0-01,0,0-01,0,0-00,0,0-01,0,0-01,0,0-01,0,0-01,0,0-01,0,0-01,0,0-00,0,0-00,0,0-00,0,0-01,0,0-01,0,0-01,0,0-03,0,0-01,0,0-01,0,0-01,0,0-01,2,0-03,0,3-01,0,0-03,0,1-01,2,0-01,0,0-01,0,0-01,0,0-01,0,0-01,0,0-01,0,0-01,0,0-01,0,0-01,2,0
02,0,0-01,2,0-01,0,0-01,0,0-00,0,0-01,0,0-03,0,1-01,2,0-03,0,3-01,0,0-04,0,1-00,0,0-01,4,0-00,0,0-04,0,3-01,0,0-01,0,0-01,0,0-01,0,0-01,0,0-01,0,0-01,2,0-03,0,3-01,0,0-03,0,1-01,2,0-01,0,0-01,0,0-01,0,0-01,0,0-03,0,2-01,0,0-01,0,0-01,0,0-01,2,0
02,0,0-01,2,0-01,0,0-01,0,0-00,0,0-01,0,0-01,0,0-01,0,0-01,0,0-01,0,0-01,0,0-00,0,0-00,0,0-00,0,0-01,0,0-01,0,0-01,0,0-03,0,2-01,0,0-01,0,0-01,0,0-01,2,0-01,2,0-01,2,0-01,2,0-01,2,0-01,0,0-01,0,0-01,0,0-00,0,0-01,2,0-00,0,0-01,0,0-01,0,0-01,2,0
02,0,0-01,2,0-01,0,0-01,2,0-01,2,0-01,2,0-01,0,0-01,0,0-01,0,0-01,0,0-01,0,0-01,0,0-04,0,0-01,0,0-01,0,0-01,0,0-01,0,0-01,2,0-01,0,0-01,0,0-01,0,0-01,0,0-01,0,0-03,2,2-01,0,0-01,0,0-01,0,0-01,0,0-01,0,0-00,0,0-00,0,0-00,0,0-01,0,0-01,0,0-01,2,0
02,0,0-01,2,0-01,0,0-01,2,0-01,2,0-01,2,0-02,0,0-00,0,0-01,2,0-01,0,0-01,0,0-01,0,0-01,0,0-01,0,0-01,0,0-01,0,0-01,0,0-04,2,2-01,0,0-01,0,0-01,0,0-01,0,0-01,0,0-00,0,0-01,0,0-01,0,0-01,0,0-01,0,0-01,0,0-00,0,0-01,0,0-00,0,0-01,0,0-01,0,0-01,3,0
02,0,0-04,0,0-01,0,0-01,2,0-01,2,0-01,2,0-01,0,0-01,0,0-01,2,0-01,0,0-01,0,0-01,0,0-03,2,0-03,2,0-03,2,0-01,0,0-01,0,0-00,0,0-01,0,0-01,0,0-01,0,0-01,0,0-01,0,0-00,0,0-01,0,0-01,0,0-01,0,0-01,0,0-01,0,0-01,0,0-01,0,0-00,0,0-01,0,0-01,0,0-01,4,0
02,0,0-01,0,0-01,0,0-02,0,0-02,0,0-01,2,0-01,0,0-01,0,0-01,2,0-03,0,3-01,0,0-01,0,0-01,2,0-01,2,0-01,2,0-01,0,0-01,0,0-00,0,0-01,0,0-01,0,0-01,0,0-01,0,0-01,0,0-01,0,0-01,0,0-01,0,0-01,0,0-01,0,0-01,0,0-00,0,0-01,0,0-00,0,0-01,0,0-01,0,0-01,4,0
02,0,0-01,0,0-01,0,0-01,2,0-01,2,0-01,2,0-01,0,0-01,0,0-01,2,0-03,0,3-01,0,0-01,0,0-03,0,0-03,0,0-03,0,0-01,0,0-01,0,0-02,0,0-01,0,0-01,0,0-01,0,0-01,0,0-01,0,0-02,0,0-01,0,0-01,0,0-01,0,0-01,0,0-00,0,0-00,0,0-01,0,0-00,0,0-00,0,0-01,2,0-01,3,0
02,0,0-01,0,0-01,0,0-03,0,0-01,2,0-01,2,0-03,0,2-03,0,2-01,2,0-01,0,0-01,0,0-01,0,0-01,0,0-01,0,0-01,0,0-01,0,0-01,0,0-04,2,0-01,0,0-01,0,0-01,0,0-01,0,0-01,0,0-01,0,0-01,0,0-01,0,0-01,0,0-01,0,0-00,0,0-01,0,0-01,0,0-01,0,0-00,0,0-01,4,0-01,3,0
02,0,0-01,0,0-01,0,0-01,0,0-01,0,0-01,0,0-01,0,0-01,0,0-01,0,0-01,0,0-01,0,0-01,0,0-03,0,2-01,0,0-01,0,0-01,0,0-04,2,3-01,2,0-04,2,1-01,0,0-01,0,0-01,0,0-01,0,0-03,4,0-01,0,0-01,0,0-01,0,0-01,0,0-00,0,0-01,0,0-01,0,0-00,0,0-00,0,0-01,2,0-01,2,0
02,0,0-01,0,0-01,2,0-01,0,0-01,0,0-01,0,0-01,0,0-01,0,0-01,0,0-01,0,0-02,0,0-01,2,0-01,2,0-03,0,3-01,0,0-01,0,0-01,0,0-00,2,0-01,0,0-01,0,0-01,0,0-01,0,0-02,0,0-01,4,0-01,0,0-01,0,0-01,0,0-01,0,0-00,0,0-01,0,0-01,0,0-00,0,0-00,0,0-01,2,0-01,3,0
02,0,0-01,0,0-01,2,0-01,2,0-00,0,0-00,0,0-01,2,0-01,2,0-01,2,0-01,0,0-01,0,0-01,2,0-01,0,0-01,0,0-01,0,0-01,0,0-01,0,0-01,0,0-01,0,0-01,0,0-01,0,0-01,0,0-02,0,0-01,4,0-03,2,3-03,0,3-01,0,0-01,0,0-00,0,0-01,0,0-01,0,0-00,0,0-00,0,0-01,2,0-01,3,0
02,0,0-01,0,0-01,2,0-01,2,0-01,2,0-01,2,0-01,2,0-00,0,0-01,2,0-01,2,0-01,2,0-01,2,0-01,0,0-01,0,0-01,0,0-01,0,0-01,0,0-01,0,0-01,0,0-01,0,0-01,0,0-01,0,0-01,0,0-01,0,0-01,0,0-01,0,0-01,0,0-01,0,0-00,0,0-00,0,0-00,0,0-00,0,0-00,0,0-01,2,0-01,2,0
02,0,0-01,0,0-01,0,0-01,0,0-01,0,0-01,0,0-01,0,0-01,0,0-01,0,0-01,0,0-01,0,0-01,0,0-01,0,0-01,0,0-01,0,0-01,0,0-01,0,0-03,0,0-01,0,0-01,0,0-01,0,0-01,0,0-01,0,0-01,0,0-01,0,0-01,0,0-01,0,0-01,0,0-01,0,0-01,0,0-01,0,0-01,0,0-01,2,0-01,2,0-01,2,0
02,0,0-01,0,0-01,0,0-01,0,0-01,0,0-01,0,0-01,0,0-01,0,0-01,0,0-01,0,0-01,0,0-01,0,0-01,0,0-01,0,0-01,0,0-01,0,0-01,0,0-01,0,0-01,0,0-01,0,0-01,0,0-01,0,0-01,0,0-01,0,0-01,0,0-01,0,0-01,0,0-01,0,0-01,0,0-01,0,0-01,0,0-01,0,0-01,2,0-01,2,0-01,2,0
02,0,0-02,0,0-02,0,0-02,0,0-02,0,0-02,0,0-02,0,0-02,0,0-02,0,0-02,0,0-02,0,0-02,0,0-02,0,0-02,0,0-02,0,0-01,4,0-01,4,0-01,3,0-01,3,0-01,0,0-01,0,0-01,0,0-01,0,0-01,0,0-01,0,0-02,0,0-02,0,0-02,0,0-02,0,0-02,0,0-01,2,0-01,2,0-01,2,0-01,2,0-01,2,0