02,0,0-02,0,0-02,0,0-02,0,0-02,0,0-02,0,0-02,0,0-02,0,0-02,0,0-02,0,0-02,0,0-02,0,0-02,0,0-02,0,0-02,0,0-02,0,0-02,0,0-02,0,0-02,0,0-02,0,0-02,0,0-02,0,0-02,0,0-02,0,0-02,0,0-02,0,0-02,0,0-02,0,0-02,0,0-02,0,0-02,0,0-02,0,0-02,0,0-02,0,0-02,0,0
02,0,0-01,0,0-01,0,0-03,0,1-00,0,0-00,0,0-01,0,0-02,0,0-01,0,0-01,0,0-01,3,0-01,0,0-01,0,0-01,0,0-01,0,0-01,3,0-00,0,0-00,0,0-01,2,0-03,0,3-01,0,0-01,0,0-01,0,0-01,0,0-01,0,0-01,0,0-01,0,0-01,0,0-01,0,0-01,0,0-01,0,0-01,0,0-01,0,0-01,0,0-02,0,0
02,0,0-01,0,0-01,0,0-01,2,0-00,0,0-00,0,0-01,0,0-01,3,0-01,0,0-01,0,0-03,0,1-01,0,0-01,0,0-01,0,0-01,0,0-01,3,0-01,2,0-01,2,0-01,2,0-00,0,0-01,0,0-01,0,0-01,0,0-01,0,0-01,0,0-01,0,0-01,0,0-01,0,0-01,0,0-01,0,0-01,0,0-01,0,0-01,0,0-01,0,0-02,0,0
02,0,0-01,0,0-01,0,0-01,2,0-00,0,0-01,0,0-01,0,0-03,0,1-01,0,0-01,0,0-02,0,0-01,3,0-01,3,0-01,3,0-03,0,2-01,3,0-01,2,0-01,2,0-01,2,0-00,0,0-01,0,0-01,0,0-01,0,0-01,0,0-01,0,0-01,0,0-01,0,0-01,0,0-01,0,0-01,0,0-01,0,0-01,0,0-01,0,0-01,0,0-02,0,0
02,0,0-01,0,0-01,0,0-01,2,0-01,3,0-03,0,0-01,2,0-01,3,0-01,0,0-01,0,0-04,0,1-00,0,0-01,3,0-02,0,0-00,0,0-01,0,0-03,0,1-00,0,0-01,2,0-00,0,0-03,0,3-01,0,0-01,0,0-01,0,0-01,0,0-01,0,0-01,0,0-01,0,0-01,0,0-01,0,0-01,0,0-01,0,0-01,0,0-01,0,0-02,0,0
02,0,0-01,0,0-01,0,0-01,2,0-01,0,0-01,0,0-01,2,0-01,3,0-01,3,0-01,3,0-01,3,0-00,0,0-01,0,0-01,0,0-01,0,0-01,0,0-03,0,1-00,0,0-01,2,0-00,0,0-03,0,3-01,0,0-01,0,0-01,0,0-01,0,0-01,0,0-01,0,0-01,0,0-01,0,0-01,0,0-01,0,0-01,0,0-01,0,0-01,0,0-02,0,0
02,0,0-00,0,0-01,0,0-03,0,0-01,0,0-01,0,0-01,2,0-00,0,0-00,0,0-00,0,0-00,0,0-00,0,0-01,0,0-01,0,0-00,0,0-01,0,0-03,0,1-00,0,0-01,2,0-00,0,0-03,0,3-01,0,0-01,0,0-01,0,0-01,0,0-01,0,0-01,0,0-01,0,0-01,0,0-01,0,0-01,0,0-01,0,0-01,0,0-01,0,0-02,0,0
02,0,0-00,0,0-01,0,0-01,0,0-01,0,0-00,0,0-01,2,0-01,2,0-01,2,0-01,2,0-01,2,0-01,0,0-01,0,0-01,0,0-01,2,0-01,0,0-03,0,1-00,0,0-01,2,0-00,0,0-03,0,3-01,0,0-01,0,0-01,0,0-01,0,0-01,0,0-01,0,0-01,0,0-01,0,0-01,0,0-01,0,0-01,0,0-01,0,0-01,0,0-02,0,0
02,0,0-00,0,0-01,0,0-01,0,0-01,0,0-01,0,0-01,0,0-01,0,0-01,0,0-03,0,1-01,2,0-01,0,0-03,0,2-01,0,0-01,2,0-01,0,0-02,0,0-01,0,0-03,0,0-01,0,0-02,0,0-01,0,0-01,0,0-01,0,0-01,0,0-01,0,0-01,0,0-01,0,0-01,0,0-01,0,0-01,0,0-01,0,0-01,0,0-01,0,0-02,0,0
02,0,0-02,0,0-01,2,0-03,0,3-01,0,0-01,0,0-01,0,0-01,0,0-01,0,0-03,0,1-01,2,0-01,2,0-01,2,0-01,2,0-01,2,0-01,0,0-01,0,0-01,0,0-01,0,0-01,0,0-01,0,0-01,0,0-01,0,0-01,0,0-01,0,0-01,0,0-01,0,0-01,0,0-01,0,0-01,0,0-01,0,0-01,0,0-01,0,0-01,0,0-02,0,0
02,0,0-02,0,0-01,2,0-01,0,0-01,0,0-01,0,0-03,0,2-01,0,0-01,0,0-03,0,1-01,2,0-01,0,0-03,0,0-01,0,0-01,2,0-03,0,3-01,0,0-01,0,0-01,0,0-01,0,0-01,0,0-01,0,0-01,0,0-01,0,0-01,0,0-01,0,0-01,0,0-01,0,0-01,0,0-01,0,0-01,0,0-01,0,0-01,0,0-01,0,0-02,0,0
02,0,0-02,0,0-01,2,0-01,0,0-01,0,0-01,0,0-01,0,0-01,0,0-01,0,0-01,0,0-01,0,0-01,0,0-01,0,0-01,0,0-01,0,0-01,0,0-01,0,0-01,0,0-01,0,0-01,0,0-01,0,0-01,0,0-01,0,0-01,0,0-01,0,0-01,0,0-01,0,0-01,0,0-01,0,0-01,0,0-01,0,0-01,0,0-01,0,0-01,0,0-02,0,0
02,0,0-01,3,0-01,2,0-01,3,0-02,0,0-01,0,0-01,0,0-01,0,0-01,0,0-01,0,0-01,0,0-01,0,0-01,0,0-01,0,0-01,0,0-01,0,0-01,0,0-01,0,0-01,0,0-01,0,0-01,0,0-01,0,0-01,0,0-01,0,0-01,0,0-01,0,0-01,0,0-01,0,0-01,0,0-01,0,0-01,0,0-01,0,0-01,0,0-01,0,0-02,0,0
02,0,0-02,0,0-01,2,0-01,2,0-01,3,0-01,0,0-04,0,2-01,0,0-01,0,0-01,2,0-01,2,0-02,0,0-01,0,0-01,0,0-02,0,0-02,0,0-01,0,0-01,0,0-01,0,0-01,0,0-01,0,0-01,0,0-01,0,0-01,0,0-01,0,0-01,0,0-01,0,0-01,0,0-01,0,0-01,0,0-01,0,0-01,0,0-01,0,0-01,0,0-02,0,0
02,0,0-02,0,0-02,0,0-01,2,0-01,2,0-01,2,0-01,2,0-01,2,0-01,2,0-01,2,0-01,2,0-02,0,0-01,0,0-01,0,0-01,0,0-01,0,0-01,0,0-01,0,0-01,0,0-01,0,0-01,0,0-01,0,0-01,0,0-01,0,0-01,0,0-01,0,0-01,0,0-01,0,0-01,0,0-01,0,0-01,0,0-01,0,0-01,0,0-01,0,0-02,0,0
02,0,0-02,0,0-01,2,0-01,2,0-01,3,0-01,3,0-01,3,0-01,3,0-01,0,0-01,2,0-01,2,0-02,0,0-01,0,0-01,0,0-02,0,0-01,2,0-00,0,0-00,0,0-00,0,0-00,0,0-03,0,3-01,0,0-01,0,0-01,0,0-01,0,0-01,0,0-01,0,0-01,0,0-01,0,0-01,0,0-01,0,0-01,0,0-01,0,0-01,0,0-02,0,0
02,0,0-01,2,0-01,2,0-01,0,0-01,0,0-01,0,0-01,3,0-01,0,0-01,0,0-01,0,0-01,0,0-01,0,0-01,0,0-01,0,0-02,0,0-01,2,0-00,0,0-00,0,0-00,0,0-03,0,3-01,0,0-01,0,0-01,0,0-01,0,0-01,0,0-01,0,0-01,0,0-01,0,0-01,0,0-01,0,0-01,0,0-01,0,0-01,0,0-01,0,0-02,0,0
02,0,0-01,2,0-01,0,0-01,0,0-01,0,0-01,0,0-01,3,0-01,0,0-01,0,0-01,0,0-01,0,0-01,0,0-01,0,0-01,0,0-02,0,0-01,2,0-00,0,0-00,0,0-03,0,3-01,0,0-01,0,0-01,0,0-01,0,0-01,0,0-01,0,0-01,0,0-01,0,0-01,0,0-01,0,0-01,0,0-01,0,0-01,0,0-01,0,0-01,0,0-02,0,0
02,0,0-01,2,0-01,3,0-01,0,0-03,0,2-01,0,0-01,0,0-01,0,0-01,0,0-01,0,0-01,0,0-01,0,0-04,0,2-01,0,0-01,0,0-01,2,0-01,2,0-01,2,0-01,0,0-01,0,0-01,0,0-01,0,0-01,0,0-01,0,0-01,0,0-01,0,0-01,0,0-01,0,0-01,0,0-01,0,0-01,0,0-01,0,0-01,0,0-01,0,0-02,0,0
02,0,0-01,2,0-01,0,0-01,0,0-00,0,0-01,0,0-01,0,0-01,0,0-01,0,0-01,0,0-01,0,0-00,0,0-00,0,0-00,0,0-01,0,0-01,0,0-01,0,0-03,0,0-01,0,0-01,0,0-01,0,0-01,0,0-01,0,0-01,0,0-01,0,0-01,0,0-01,0,0-01,0,0-01,0,0-01,0,0-01,0,0-01,0,0-01,0,0-01,0,0-02,0,0
02,0,0-01,2,0-01,0,0-01,0,0-00,0,0-01,0,0-01,0,0-01,0,0-01,0,0-01,0,0-04,0,1-00,0,0-01,4,0-00,0,0-04,0,3-01,0,0-01,0,0-01,0,0-01,0,0-01,0,0-01,0,0-01,0,0-01,0,0-01,0,0-01,0,0-01,0,0-01,0,0-01,0,0-01,0,0-01,0,0-01,0,0-01,0,0-01,0,0-01,0,0-02,0,0
02,0,0-01,2,0-01,0,0-01,0,0-00,0,0-01,0,0-01,0,0-01,0,0-01,0,0-01,0,0-01,0,0-00,0,0-00,0,0-00,0,0-01,0,0-01,0,0-01,0,0-01,0,0-01,0,0-01,0,0-01,0,0-01,0,0-01,0,0-01,0,0-01,0,0-01,0,0-01,0,0-01,0,0-01,0,0-01,0,0-01,0,0-01,0,0-01,0,0-01,0,0-02,0,0
02,0,0-01,2,0-01,0,0-01,2,0-01,2,0-01,2,0-01,0,0-01,0,0-01,0,0-01,0,0-01,0,0-01,0,0-04,0,0-01,0,0-01,0,0-01,0,0-01,0,0-01,0,0-01,0,0-01,0,0-01,0,0-01,0,0-01,0,0-01,0,0-01,0,0-01,0,0-01,0,0-01,0,0-01,0,0-01,0,0-01,0,0-01,0,0-01,0,0-01,0,0-02,0,0
02,0,0-01,2,0-01,0,0-01,2,0-01,2,0-01,2,0-02,0,0-00,0,0-01,2,0-01,0,0-01,0,0-01,0,0-01,0,0-01,0,0-01,0,0-01,0,0-01,0,0-01,0,0-01,0,0-01,0,0-01,0,0-01,0,0-01,0,0-01,0,0-01,0,0-01,0,0-01,0,0-01,0,0-01,0,0-01,0,0-01,0,0-01,0,0-01,0,0-01,0,0-02,0,0
02,0,0-04,0,0-01,0,0-01,2,0-01,2,0-01,2,0-01,0,0-01,0,0-01,2,0-01,0,0-01,0,0-01,0,0-01,0,0-01,0,0-01,0,0-01,0,0-01,0,0-01,0,0-01,0,0-01,0,0-01,0,0-01,0,0-01,0,0-01,0,0-01,0,0-01,0,0-01,0,0-01,0,0-01,0,0-01,0,0-01,0,0-01,0,0-01,0,0-01,0,0-02,0,0
02,0,0-01,0,0-01,0,0-02,0,0-02,0,0-01,2,0-01,0,0-01,0,0-01,2,0-03,0,3-01,0,0-01,0,0-01,0,0-01,0,0-01,0,0-01,0,0-01,0,0-01,0,0-01,0,0-01,0,0-01,0,0-01,0,0-01,0,0-01,0,0-01,0,0-01,0,0-01,0,0-01,0,0-01,0,0-01,0,0-01,0,0-01,0,0-01,0,0-01,0,0-02,0,0
02,0,0-01,0,0-01,0,0-01,2,0-01,2,0-01,2,0-01,0,0-01,0,0-01,2,0-03,0,3-01,0,0-01,0,0-01,0,0-01,0,0-01,0,0-01,0,0-01,0,0-01,0,0-01,0,0-01,0,0-01,0,0-01,0,0-01,0,0-01,0,0-01,0,0-01,0,0-01,0,0-01,0,0-01,0,0-01,0,0-01,0,0-01,0,0-01,0,0-01,0,0-02,0,0
02,0,0-01,0,0-01,0,0-03,0,0-01,2,0-01,2,0-03,0,2-03,0,2-01,2,0-01,0,0-01,0,0-01,0,0-01,0,0-01,0,0-01,0,0-01,0,0-01,0,0-01,0,0-01,0,0-01,0,0-01,0,0-01,0,0-01,0,0-01,0,0-01,0,0-01,0,0-01,0,0-01,0,0-01,0,0-01,0,0-01,0,0-01,0,0-01,0,0-01,0,0-02,0,0
02,0,0-01,0,0-01,0,0-01,0,0-01,0,0-01,0,0-01,0,0-01,0,0-01,0,0-01,0,0-01,0,0-01,0,0-03,0,2-01,0,0-01,0,0-01,0,0-01,0,0-01,0,0-01,0,0-01,0,0-01,0,0-01,0,0-01,0,0-01,0,0-01,0,0-01,0,0-01,0,0-01,0,0-01,0,0-01,0,0-01,0,0-01,0,0-01,0,0-01,0,0-02,0,0
02,0,0-01,0,0-01,2,0-01,0,0-01,0,0-01,0,0-01,0,0-01,0,0-01,0,0-01,0,0-02,0,0-01,2,0-01,2,0-03,0,3-01,0,0-01,0,0-01,0,0-01,0,0-01,0,0-01,0,0-01,0,0-01,0,0-01,0,0-01,0,0-01,0,0-01,0,0-01,0,0-01,0,0-01,0,0-01,0,0-01,0,0-01,0,0-01,0,0-01,0,0-02,0,0
02,0,0-01,0,0-01,2,0-01,2,0-00,0,0-00,0,0-01,2,0-01,2,0-01,2,0-01,0,0-01,0,0-01,2,0-01,0,0-01,0,0-01,0,0-01,0,0-01,0,0-01,0,0-01,0,0-01,0,0-01,0,0-01,0,0-01,0,0-01,0,0-01,0,0-01,0,0-01,0,0-01,0,0-01,0,0-01,0,0-01,0,0-01,0,0-01,0,0-01,0,0-02,0,0
02,0,0-01,0,0-01,2,0-01,2,0-01,2,0-01,2,0-01,2,0-00,0,0-01,2,0-01,2,0-01,2,0-01,2,0-01,0,0-01,0,0-01,0,0-01,0,0-01,0,0-01,0,0-01,0,0-01,0,0-01,0,0-01,0,0-01,0,0-01,0,0-01,0,0-01,0,0-01,0,0-01,0,0-01,0,0-01,0,0-01,0,0-01,0,0-01,0,0-01,0,0-02,0,0
02,0,0-01,0,0-01,0,0-01,0,0-01,0,0-01,0,0-01,0,0-01,0,0-01,0,0-01,0,0-01,0,0-01,0,0-01,0,0-01,0,0-01,0,0-01,0,0-01,0,0-01,0,0-01,0,0-01,0,0-01,0,0-01,0,0-01,0,0-01,0,0-01,0,0-01,0,0-01,0,0-01,0,0-01,0,0-01,0,0-01,0,0-01,0,0-01,0,0-01,0,0-02,0,0
02,0,0-01,0,0-01,0,0-01,0,0-01,0,0-01,0,0-01,0,0-01,0,0-01,0,0-01,0,0-01,0,0-01,0,0-01,0,0-01,0,0-01,0,0-01,0,0-01,0,0-01,0,0-01,0,0-01,0,0-01,0,0-01,0,0-01,0,0-01,0,0-01,0,0-01,0,0-01,0,0-01,0,0-01,0,0-01,0,0-01,0,0-01,0,0-01,0,0-01,0,0-02,0,0
02,0,0-02,0,0-02,0,0-02,0,0-02,0,0-02,0,0-02,0,0-02,0,0-02,0,0-02,0,0-02,0,0-02,0,0-02,0,0-02,0,0-02,0,0-02,0,0-02,0,0-02,0,0-02,0,0-02,0,0-02,0,0-02,0,0-02,0,0-02,0,0-02,0,0-02,0,0-02,0,0-02,0,0-02,0,0-02,0,0-02,0,0-02,0,0-02,0,0-02,0,0-02,0,0