02,0,0-02,0,0-02,0,0-02,0,0-02,0,0-02,0,0-02,0,0-02,0,0-02,0,0-02,0,0-02,0,0-02,0,0-02,0,0-02,0,0-02,0,0-02,0,0-02,0,0-02,0,0-02,0,0-02,0,0-02,0,0-02,0,0-02,0,0-02,0,0-02,0,0-02,0,0-02,0,0-02,0,0-02,0,0-02,0,0-02,0,0-02,0,0-02,0,0-02,0,0-02,0,0
02,0,0-01,0,0-01,0,0-01,0,0-01,0,0-01,0,0-01,0,0-01,0,0-01,0,0-01,0,0-01,0,0-01,0,0-01,0,0-01,0,0-01,0,0-01,0,0-01,0,0-01,0,0-01,0,0-01,0,0-01,0,0-01,0,0-01,0,0-01,0,0-01,0,0-01,0,0-01,0,0-01,0,0-01,0,0-01,0,0-01,0,0-01,0,0-01,0,0-01,0,0-02,0,0
02,0,0-01,0,0-01,0,0-01,0,0-01,0,0-01,0,0-01,0,0-01,0,0-01,0,0-01,0,0-01,0,0-01,0,0-01,0,0-01,0,0-01,0,0-01,0,0-01,0,0-01,0,0-01,0,0-01,0,0-01,0,0-01,0,0-01,0,0-01,0,0-01,0,0-01,0,0-01,0,0-01,0,0-01,0,0-01,0,0-01,0,0-01,0,0-01,0,0-01,0,0-02,0,0
02,0,0-01,0,0-01,0,0-01,0,0-01,0,0-01,0,0-01,0,0-01,0,0-01,0,0-01,0,0-01,0,0-01,0,0-01,0,0-01,0,0-01,0,0-01,0,0-01,0,0-01,0,0-01,0,0-01,0,0-01,0,0-01,0,0-01,0,0-01,0,0-01,0,0-01,0,0-01,0,0-01,0,0-01,0,0-01,0,0-01,0,0-01,0,0-01,0,0-01,0,0-02,0,0
02,0,0-01,0,0-01,0,0-01,0,0-01,0,0-01,0,0-01,0,0-01,0,0-01,0,0-01,0,0-01,0,0-01,0,0-01,0,0-01,0,0-01,0,0-01,0,0-01,0,0-01,0,0-01,0,0-01,0,0-01,0,0-01,0,0-01,0,0-01,0,0-01,0,0-01,0,0-01,0,0-01,0,0-01,0,0-01,0,0-01,0,0-01,0,0-01,0,0-01,0,0-02,0,0
02,0,0-01,0,0-01,0,0-01,0,0-01,0,0-01,0,0-01,0,0-01,0,0-01,0,0-01,0,0-01,0,0-01,0,0-01,0,0-01,0,0-01,0,0-01,0,0-01,0,0-01,0,0-01,0,0-01,0,0-01,0,0-01,0,0-01,0,0-01,0,0-01,0,0-01,0,0-01,0,0-01,0,0-01,0,0-01,0,0-01,0,0-01,0,0-01,0,0-01,0,0-02,0,0
02,0,0-01,0,0-01,0,0-01,0,0-01,0,0-01,0,0-01,0,0-01,0,0-01,0,0-01,0,0-01,0,0-01,0,0-01,0,0-01,0,0-01,0,0-01,0,0-01,0,0-01,0,0-01,0,0-01,0,0-01,0,0-01,0,0-01,0,0-01,0,0-01,0,0-01,0,0-01,0,0-01,0,0-01,0,0-01,0,0-01,0,0-01,0,0-01,0,0-01,0,0-02,0,0
02,0,0-01,0,0-01,0,0-01,0,0-01,0,0-01,0,0-01,0,0-01,0,0-01,0,0-01,0,0-01,0,0-01,0,0-01,0,0-01,0,0-01,0,0-01,0,0-01,0,0-01,0,0-01,0,0-01,0,0-01,0,0-01,0,0-01,0,0-01,0,0-01,0,0-01,0,0-01,0,0-01,0,0-01,0,0-01,0,0-01,0,0-01,0,0-01,0,0-01,0,0-02,0,0
02,0,0-01,0,0-01,0,0-01,0,0-01,0,0-01,0,0-01,0,0-01,0,0-01,0,0-01,0,0-01,0,0-01,0,0-01,0,0-01,0,0-01,0,0-01,0,0-01,0,0-01,0,0-01,0,0-01,0,0-01,0,0-01,0,0-01,0,0-01,0,0-01,0,0-01,0,0-01,0,0-01,0,0-01,0,0-01,0,0-01,0,0-01,0,0-01,0,0-01,0,0-02,0,0
02,0,0-01,0,0-01,0,0-01,0,0-01,0,0-01,0,0-01,0,0-01,0,0-01,0,0-01,0,0-01,0,0-01,0,0-01,0,0-01,0,0-01,0,0-01,0,0-01,0,0-01,0,0-01,0,0-01,0,0-01,0,0-01,0,0-01,0,0-01,0,0-01,0,0-01,0,0-01,0,0-01,0,0-01,0,0-01,0,0-01,0,0-01,0,0-01,0,0-01,0,0-02,0,0
02,0,0-01,0,0-01,0,0-01,0,0-01,0,0-01,0,0-01,0,0-01,0,0-01,0,0-01,0,0-01,0,0-01,0,0-01,0,0-01,0,0-01,0,0-01,0,0-01,0,0-01,0,0-01,0,0-01,0,0-01,0,0-01,0,0-01,0,0-01,0,0-01,0,0-01,0,0-01,0,0-01,0,0-01,0,0-01,0,0-01,0,0-01,0,0-01,0,0-01,0,0-02,0,0
02,0,0-01,0,0-01,0,0-01,0,0-01,0,0-01,0,0-01,0,0-01,0,0-01,0,0-01,0,0-01,0,0-01,0,0-01,0,0-01,0,0-01,0,0-01,0,0-01,0,0-01,0,0-01,0,0-01,0,0-01,0,0-01,0,0-01,0,0-01,0,0-01,0,0-01,0,0-01,0,0-01,0,0-01,0,0-01,0,0-01,0,0-01,0,0-01,0,0-01,0,0-02,0,0
02,0,0-01,0,0-01,0,0-01,0,0-01,0,0-01,0,0-01,0,0-01,0,0-01,0,0-01,0,0-01,0,0-01,0,0-01,0,0-01,0,0-01,0,0-01,0,0-01,0,0-01,0,0-01,0,0-01,0,0-01,0,0-01,0,0-01,0,0-01,0,0-01,0,0-01,0,0-01,0,0-01,0,0-01,0,0-01,0,0-01,0,0-01,0,0-01,0,0-01,0,0-02,0,0
02,0,0-01,0,0-01,0,0-01,0,0-01,0,0-01,0,0-01,0,0-01,0,0-01,0,0-01,0,0-01,0,0-01,0,0-01,0,0-01,0,0-01,0,0-01,0,0-01,0,0-01,0,0-01,0,0-01,0,0-01,0,0-01,0,0-01,0,0-01,0,0-01,0,0-01,0,0-01,0,0-01,0,0-01,0,0-01,0,0-01,0,0-01,0,0-01,0,0-01,0,0-02,0,0
02,0,0-01,0,0-01,0,0-01,0,0-01,0,0-01,0,0-01,0,0-01,0,0-01,0,0-01,0,0-01,0,0-01,0,0-01,0,0-01,0,0-01,0,0-01,0,0-01,0,0-01,0,0-01,0,0-01,0,0-01,0,0-01,0,0-01,0,0-01,0,0-01,0,0-01,0,0-01,0,0-01,0,0-01,0,0-01,0,0-01,0,0-01,0,0-01,0,0-01,0,0-02,0,0
02,0,0-01,0,0-01,0,0-01,0,0-01,0,0-01,0,0-01,0,0-01,0,0-01,0,0-01,0,0-01,0,0-01,0,0-01,0,0-01,0,0-01,0,0-01,0,0-01,0,0-01,0,0-01,0,0-01,0,0-01,0,0-01,0,0-01,0,0-01,0,0-01,0,0-01,0,0-01,0,0-01,0,0-01,0,0-01,0,0-01,0,0-01,0,0-01,0,0-01,0,0-02,0,0
02,0,0-01,0,0-01,0,0-01,0,0-01,0,0-01,0,0-01,0,0-01,0,0-01,0,0-01,0,0-01,0,0-01,0,0-01,0,0-01,0,0-01,0,0-01,0,0-01,0,0-01,0,0-01,0,0-01,0,0-01,0,0-01,0,0-01,0,0-01,0,0-01,0,0-01,0,0-01,0,0-01,0,0-01,0,0-01,0,0-01,0,0-01,0,0-01,0,0-01,0,0-02,0,0
02,0,0-01,0,0-01,0,0-01,0,0-01,0,0-01,0,0-01,0,0-01,0,0-01,0,0-01,0,0-01,0,0-01,0,0-01,0,0-01,0,0-01,0,0-01,0,0-01,0,0-01,0,0-01,0,0-01,0,0-01,0,0-01,0,0-01,0,0-01,0,0-01,0,0-01,0,0-01,0,0-01,0,0-01,0,0-01,0,0-01,0,0-01,0,0-01,0,0-01,0,0-02,0,0
02,0,0-01,0,0-01,0,0-01,0,0-01,0,0-01,0,0-01,0,0-01,0,0-01,0,0-01,0,0-01,0,0-01,0,0-01,0,0-01,0,0-01,0,0-01,0,0-01,0,0-01,0,0-01,0,0-01,0,0-01,0,0-01,0,0-01,0,0-01,0,0-01,0,0-01,0,0-01,0,0-01,0,0-01,0,0-01,0,0-01,0,0-01,0,0-01,0,0-01,0,0-02,0,0
02,0,0-01,0,0-01,0,0-01,0,0-01,0,0-01,0,0-01,0,0-01,0,0-01,0,0-01,0,0-01,0,0-01,0,0-01,0,0-01,0,0-01,0,0-01,0,0-01,0,0-01,0,0-01,0,0-01,0,0-01,0,0-01,0,0-01,0,0-01,0,0-01,0,0-01,0,0-01,0,0-01,0,0-01,0,0-01,0,0-01,0,0-01,0,0-01,0,0-01,0,0-02,0,0
02,0,0-01,0,0-01,0,0-01,0,0-01,0,0-01,0,0-01,0,0-01,0,0-01,0,0-01,0,0-01,0,0-01,0,0-01,0,0-01,0,0-01,0,0-01,0,0-01,0,0-01,0,0-01,0,0-01,0,0-01,0,0-01,0,0-01,0,0-01,0,0-01,0,0-01,0,0-01,0,0-01,0,0-01,0,0-01,0,0-01,0,0-01,0,0-01,0,0-01,0,0-02,0,0
02,0,0-01,0,0-01,0,0-01,0,0-01,0,0-01,0,0-01,0,0-01,0,0-01,0,0-01,0,0-01,0,0-01,0,0-01,0,0-01,0,0-01,0,0-01,0,0-01,0,0-01,0,0-01,0,0-01,0,0-01,0,0-01,0,0-01,0,0-01,0,0-01,0,0-01,0,0-01,0,0-01,0,0-01,0,0-01,0,0-01,0,0-01,0,0-01,0,0-01,0,0-02,0,0
02,0,0-01,0,0-01,0,0-01,2,0-01,2,0-01,2,0-01,0,0-01,0,0-01,0,0-01,0,0-01,0,0-01,0,0-01,0,0-01,0,0-01,0,0-01,0,0-01,0,0-01,0,0-01,0,0-01,0,0-01,0,0-01,0,0-01,0,0-01,0,0-01,0,0-01,0,0-01,0,0-01,0,0-01,0,0-01,0,0-01,0,0-01,0,0-01,0,0-01,0,0-02,0,0
02,0,0-01,0,0-01,0,0-01,2,0-01,2,0-01,2,0-02,0,0-01,0,0-01,2,0-01,0,0-01,0,0-01,0,0-01,0,0-01,0,0-01,0,0-01,0,0-01,0,0-01,0,0-01,0,0-01,0,0-01,0,0-01,0,0-01,0,0-01,0,0-01,0,0-01,0,0-01,0,0-01,0,0-01,0,0-01,0,0-01,0,0-01,0,0-01,0,0-01,0,0-02,0,0
02,0,0-01,0,0-01,0,0-01,2,0-01,2,0-01,2,0-01,0,0-01,0,0-01,2,0-01,0,0-01,0,0-01,0,0-01,0,0-01,0,0-01,0,0-01,0,0-01,0,0-01,0,0-01,0,0-01,0,0-01,0,0-01,0,0-01,0,0-01,0,0-01,0,0-01,0,0-01,0,0-01,0,0-01,0,0-01,0,0-01,0,0-01,0,0-01,0,0-01,0,0-02,0,0
02,0,0-01,0,0-01,0,0-01,0,0-02,0,0-01,2,0-01,0,0-01,0,0-01,2,0-03,0,3-01,0,0-01,0,0-01,0,0-01,0,0-01,0,0-01,0,0-01,0,0-01,0,0-01,0,0-01,0,0-01,0,0-01,0,0-01,0,0-01,0,0-01,0,0-01,0,0-01,0,0-01,0,0-01,0,0-01,0,0-01,0,0-01,0,0-01,0,0-01,0,0-02,0,0
02,0,0-01,0,0-01,0,0-01,2,0-01,2,0-01,2,0-01,0,0-01,0,0-01,2,0-03,0,3-01,0,0-01,0,0-01,0,0-01,0,0-01,0,0-01,0,0-01,0,0-01,0,0-01,0,0-01,0,0-01,0,0-01,0,0-01,0,0-01,0,0-01,0,0-01,0,0-01,0,0-01,0,0-01,0,0-01,0,0-01,0,0-01,0,0-01,0,0-01,0,0-02,0,0
02,0,0-01,0,0-01,0,0-01,0,0-01,2,0-01,2,0-01,2,0-01,2,0-01,2,0-01,0,0-01,0,0-01,0,0-01,0,0-01,0,0-01,0,0-01,0,0-01,0,0-01,0,0-01,0,0-01,0,0-01,0,0-01,0,0-01,0,0-01,0,0-01,0,0-01,0,0-01,0,0-01,0,0-01,0,0-01,0,0-01,0,0-01,0,0-01,0,0-01,0,0-02,0,0
02,0,0-01,0,0-01,0,0-01,0,0-03,0,0-01,0,0-01,0,0-01,0,0-01,0,0-01,0,0-01,0,0-01,0,0-01,0,0-01,0,0-01,0,0-01,0,0-01,0,0-01,0,0-01,0,0-01,0,0-01,0,0-01,0,0-01,0,0-01,0,0-01,0,0-01,0,0-01,0,0-01,0,0-01,0,0-01,0,0-01,0,0-01,0,0-01,0,0-01,0,0-02,0,0
02,0,0-01,0,0-01,0,0-01,0,0-01,0,0-01,0,0-01,0,0-01,0,0-01,0,0-01,0,0-01,0,0-01,0,0-01,0,0-01,0,0-01,0,0-01,0,0-01,0,0-01,0,0-01,0,0-01,0,0-01,0,0-01,0,0-01,0,0-01,0,0-01,0,0-01,0,0-01,0,0-01,0,0-01,0,0-01,0,0-01,0,0-01,0,0-01,0,0-01,0,0-02,0,0
02,0,0-01,0,0-01,0,0-01,0,0-01,0,0-01,0,0-01,0,0-01,0,0-01,0,0-01,0,0-01,0,0-01,0,0-01,0,0-01,0,0-01,0,0-01,0,0-01,0,0-01,0,0-01,0,0-01,0,0-01,0,0-01,0,0-01,0,0-01,0,0-01,0,0-01,0,0-01,0,0-01,0,0-01,0,0-01,0,0-01,0,0-01,0,0-01,0,0-01,0,0-02,0,0
02,0,0-01,0,0-01,0,0-01,0,0-01,0,0-01,0,0-01,0,0-01,0,0-01,0,0-01,0,0-01,0,0-01,0,0-01,0,0-01,0,0-01,0,0-01,0,0-01,0,0-01,0,0-01,0,0-01,0,0-01,0,0-01,0,0-01,0,0-01,0,0-01,0,0-01,0,0-01,0,0-01,0,0-01,0,0-01,0,0-01,0,0-01,0,0-01,0,0-01,0,0-02,0,0
02,0,0-01,0,0-01,0,0-01,0,0-01,0,0-01,0,0-01,0,0-01,0,0-01,0,0-01,0,0-01,0,0-01,0,0-01,0,0-01,0,0-01,0,0-01,0,0-01,0,0-01,0,0-01,0,0-01,0,0-01,0,0-01,0,0-01,0,0-01,0,0-01,0,0-01,0,0-01,0,0-01,0,0-01,0,0-01,0,0-01,0,0-01,0,0-01,0,0-01,0,0-02,0,0
02,0,0-01,0,0-01,0,0-01,0,0-01,0,0-01,0,0-01,0,0-01,0,0-01,0,0-01,0,0-01,0,0-01,0,0-01,0,0-01,0,0-01,0,0-01,0,0-01,0,0-01,0,0-01,0,0-01,0,0-01,0,0-01,0,0-01,0,0-01,0,0-01,0,0-01,0,0-01,0,0-01,0,0-01,0,0-01,0,0-01,0,0-01,0,0-01,0,0-01,0,0-02,0,0
02,0,0-02,0,0-02,0,0-02,0,0-02,0,0-02,0,0-02,0,0-02,0,0-02,0,0-02,0,0-02,0,0-02,0,0-02,0,0-02,0,0-02,0,0-02,0,0-02,0,0-02,0,0-02,0,0-02,0,0-02,0,0-02,0,0-02,0,0-02,0,0-02,0,0-02,0,0-02,0,0-02,0,0-02,0,0-02,0,0-02,0,0-02,0,0-02,0,0-02,0,0-02,0,0