02,0,0-02,0,0-02,0,0-02,0,0-02,0,0-02,0,0-02,0,0-02,0,0-02,0,0-02,0,0-02,0,0-02,0,0-02,0,0-02,0,0-02,0,0-02,0,0-02,0,0-02,0,0-02,0,0-02,0,0-02,0,0-02,0,0-02,0,0-02,0,0-02,0,0-02,0,0-02,0,0-02,0,0-02,0,0-02,0,0
02,0,0-01,0,0-01,0,0-03,0,1-00,0,0-03,0,3-01,0,0-01,0,0-01,0,0-01,0,0-01,0,0-01,0,0-01,0,0-01,0,0-01,0,0-01,0,0-01,0,0-01,0,0-01,0,0-01,0,0-01,0,0-01,0,0-01,0,0-01,0,0-01,0,0-01,0,0-01,0,0-01,0,0-01,0,0-02,0,0
02,0,0-01,0,0-01,0,0-03,0,1-00,0,0-03,0,3-01,0,0-01,0,0-01,0,0-01,0,0-01,0,0-01,0,0-01,0,0-01,0,0-01,0,0-01,0,0-01,0,0-01,0,0-01,0,0-01,0,0-01,0,0-01,0,0-01,0,0-01,0,0-01,0,0-01,0,0-01,0,0-01,0,0-01,0,0-02,0,0
02,0,0-01,0,0-01,0,0-03,0,1-00,0,0-03,0,3-01,0,0-01,0,0-01,0,0-01,0,0-01,0,0-01,0,0-01,0,0-01,0,0-01,0,0-01,0,0-01,0,0-01,0,0-01,0,0-01,0,0-01,0,0-01,0,0-01,0,0-01,0,0-01,0,0-01,0,0-01,0,0-01,0,0-01,0,0-02,0,0
02,0,0-01,0,0-01,0,0-01,0,0-01,0,0-01,0,0-01,0,0-01,0,0-01,0,0-01,0,0-01,0,0-01,0,0-01,0,0-01,0,0-01,0,0-01,0,0-01,0,0-01,0,0-01,0,0-01,0,0-01,0,0-01,0,0-01,0,0-01,0,0-01,0,0-01,0,0-01,0,0-01,0,0-01,0,0-02,0,0
02,0,0-01,0,0-01,0,0-01,0,0-01,0,0-01,0,0-01,0,0-01,0,0-01,0,0-01,0,0-01,0,0-01,0,0-01,0,0-01,0,0-01,0,0-01,0,0-01,0,0-01,0,0-01,0,0-01,0,0-01,0,0-01,0,0-01,0,0-01,0,0-01,0,0-01,0,0-01,0,0-01,0,0-01,0,0-02,0,0
02,0,0-01,0,0-01,0,0-01,0,0-01,0,0-01,0,0-01,0,0-01,0,0-01,0,0-01,0,0-01,0,0-01,0,0-01,0,0-01,0,0-01,0,0-01,0,0-01,0,0-01,0,0-01,0,0-01,0,0-01,0,0-01,0,0-01,0,0-01,0,0-01,0,0-01,0,0-01,0,0-01,0,0-01,0,0-02,0,0
02,0,0-01,0,0-01,0,0-01,0,0-01,0,0-01,0,0-01,0,0-01,0,0-01,0,0-01,0,0-01,0,0-01,0,0-01,0,0-01,0,0-01,0,0-01,0,0-01,0,0-01,0,0-01,0,0-01,0,0-01,0,0-01,0,0-01,0,0-01,0,0-01,0,0-01,0,0-01,0,0-01,0,0-01,0,0-02,0,0
02,0,0-01,0,0-03,0,1-01,2,0-01,2,0-01,0,0-01,0,0-01,0,0-01,0,0-01,0,0-01,0,0-01,0,0-01,0,0-01,0,0-01,0,0-01,0,0-01,0,0-01,0,0-01,0,0-01,0,0-01,0,0-01,0,0-01,0,0-01,0,0-01,0,0-01,0,0-01,0,0-01,0,0-01,0,0-02,0,0
02,0,0-01,0,0-01,0,0-01,0,0-01,0,0-01,0,0-01,0,0-01,0,0-01,0,0-01,0,0-01,0,0-01,0,0-01,0,0-01,0,0-01,0,0-01,0,0-01,0,0-01,0,0-01,0,0-01,0,0-01,0,0-01,0,0-01,0,0-01,0,0-01,0,0-01,0,0-01,0,0-01,0,0-01,0,0-02,0,0
02,0,0-01,0,0-01,0,0-01,0,0-01,0,0-01,0,0-01,0,0-01,2,0-01,2,0-01,2,0-01,2,0-01,0,0-01,0,0-01,0,0-01,0,0-01,0,0-01,0,0-01,0,0-01,0,0-01,0,0-01,0,0-01,0,0-01,0,0-01,0,0-01,0,0-01,0,0-01,0,0-01,0,0-01,0,0-02,0,0
02,0,0-01,0,0-01,0,0-01,0,0-01,0,0-01,0,0-01,0,0-01,0,0-01,0,0-01,0,0-01,2,0-01,0,0-01,0,0-01,0,0-01,0,0-01,0,0-01,0,0-01,0,0-01,0,0-01,0,0-01,0,0-01,0,0-01,0,0-01,0,0-01,0,0-01,0,0-01,0,0-01,0,0-01,0,0-02,0,0
02,0,0-01,0,0-01,0,0-01,0,0-01,0,0-01,0,0-01,0,0-01,0,0-01,0,0-01,0,0-01,2,0-01,0,0-01,0,0-01,0,0-01,0,0-01,0,0-01,0,0-01,0,0-01,0,0-01,0,0-01,0,0-01,0,0-01,0,0-01,0,0-01,0,0-01,0,0-01,0,0-01,0,0-01,0,0-02,0,0
02,0,0-01,0,0-01,0,0-01,0,0-01,0,0-01,0,0-01,0,0-01,0,0-01,0,0-01,0,0-01,2,0-01,0,0-01,0,0-01,0,0-01,0,0-01,0,0-01,0,0-01,0,0-01,0,0-01,0,0-01,0,0-01,0,0-01,0,0-01,0,0-01,0,0-01,0,0-01,0,0-01,0,0-01,0,0-02,0,0
02,0,0-01,0,0-01,0,0-01,0,0-01,0,0-01,0,0-01,0,0-01,0,0-01,0,0-01,0,0-01,2,0-01,0,0-01,0,0-01,0,0-01,0,0-01,0,0-01,0,0-01,0,0-01,0,0-01,0,0-01,0,0-01,0,0-01,0,0-01,0,0-01,0,0-01,0,0-01,0,0-01,0,0-01,0,0-02,0,0
02,0,0-01,0,0-01,0,0-01,0,0-01,0,0-01,0,0-01,0,0-01,0,0-01,0,0-01,0,0-01,2,0-01,0,0-01,0,0-01,0,0-01,0,0-01,0,0-01,0,0-01,0,0-01,0,0-01,0,0-01,0,0-01,0,0-01,0,0-01,0,0-01,0,0-01,0,0-01,0,0-01,0,0-01,0,0-02,0,0
02,0,0-01,0,0-01,0,0-01,0,0-01,0,0-01,0,0-01,0,0-01,0,0-01,0,0-01,0,0-01,2,0-01,0,0-01,0,0-01,0,0-01,0,0-01,0,0-01,0,0-01,0,0-01,0,0-01,0,0-01,0,0-01,0,0-01,0,0-01,0,0-01,0,0-01,0,0-01,0,0-01,0,0-01,0,0-02,0,0
02,0,0-01,0,0-01,0,0-01,0,0-01,0,0-01,0,0-01,0,0-01,0,0-01,0,0-01,0,0-01,2,0-01,0,0-01,0,0-01,0,0-01,0,0-01,0,0-01,0,0-01,0,0-01,0,0-01,0,0-01,0,0-01,0,0-01,0,0-01,0,0-01,0,0-01,0,0-01,0,0-01,0,0-01,0,0-02,0,0
02,0,0-01,0,0-01,0,0-01,0,0-01,0,0-01,0,0-01,0,0-01,0,0-01,0,0-01,0,0-01,2,0-01,0,0-01,0,0-01,0,0-01,0,0-01,0,0-01,0,0-01,0,0-01,0,0-01,0,0-01,0,0-01,0,0-01,0,0-01,0,0-01,0,0-01,0,0-01,0,0-01,0,0-01,0,0-02,0,0
02,0,0-01,0,0-01,0,0-01,0,0-01,0,0-01,0,0-01,0,0-01,0,0-01,0,0-01,2,0-01,2,0-01,2,0-01,2,0-01,2,0-01,0,0-01,0,0-01,0,0-01,0,0-01,0,0-01,0,0-01,0,0-01,0,0-01,0,0-01,0,0-01,0,0-01,0,0-01,0,0-01,0,0-01,0,0-02,0,0
02,0,0-01,0,0-01,0,0-01,0,0-01,0,0-01,0,0-01,0,0-01,0,0-01,1,0-01,2,0-01,2,0-01,2,0-01,2,0-01,2,0-01,0,0-01,0,0-01,0,0-01,0,0-01,0,0-01,0,0-01,0,0-01,0,0-01,0,0-01,0,0-01,0,0-01,0,0-01,0,0-01,0,0-01,0,0-02,0,0
02,0,0-01,0,0-01,0,0-01,0,0-01,0,0-01,0,0-01,0,0-01,0,0-01,1,0-01,2,0-03,0,3-01,0,0-01,0,0-01,2,0-01,0,0-01,0,0-01,0,0-01,0,0-01,0,0-01,0,0-01,0,0-01,0,0-01,0,0-01,0,0-01,0,0-01,0,0-01,0,0-01,0,0-01,0,0-02,0,0
02,0,0-01,0,0-01,0,0-01,0,0-01,0,0-01,0,0-01,0,0-01,0,0-01,1,0-01,2,0-03,0,3-01,0,0-01,0,0-01,2,0-01,0,0-01,0,0-01,0,0-01,0,0-01,0,0-01,0,0-01,0,0-01,0,0-01,0,0-01,0,0-01,0,0-01,0,0-01,0,0-01,0,0-01,0,0-02,0,0
02,0,0-01,0,0-01,0,0-01,0,0-01,0,0-01,0,0-01,0,0-01,0,0-01,1,0-01,2,0-03,0,3-01,0,0-01,0,0-01,2,0-01,0,0-01,0,0-01,0,0-01,0,0-01,0,0-01,0,0-01,0,0-01,0,0-01,0,0-01,0,0-01,0,0-01,0,0-01,0,0-01,0,0-01,0,0-02,0,0
02,0,0-01,0,0-01,0,0-01,0,0-01,0,0-01,0,0-01,0,0-01,0,0-01,1,0-01,2,0-03,0,3-01,0,0-01,0,0-01,0,0-01,0,0-01,0,0-01,0,0-01,0,0-01,0,0-01,0,0-01,0,0-01,0,0-01,0,0-01,0,0-01,0,0-01,0,0-01,0,0-01,0,0-01,0,0-02,0,0
02,0,0-01,0,0-01,0,0-01,0,0-01,0,0-01,0,0-01,0,0-01,0,0-01,2,0-01,2,0-01,0,0-01,0,0-01,0,0-01,0,0-01,0,0-01,0,0-01,0,0-01,0,0-01,0,0-01,0,0-01,0,0-01,0,0-01,0,0-01,0,0-01,0,0-01,0,0-01,0,0-01,0,0-01,0,0-02,0,0
02,0,0-01,0,0-01,0,0-01,0,0-01,0,0-01,0,0-01,0,0-01,0,0-01,2,0-01,2,0-01,0,0-01,0,0-01,0,0-01,0,0-01,0,0-01,0,0-01,0,0-01,0,0-01,0,0-01,0,0-01,0,0-01,0,0-01,0,0-01,0,0-01,0,0-01,0,0-01,0,0-01,0,0-01,0,0-02,0,0
02,0,0-01,0,0-01,0,0-01,0,0-01,0,0-01,0,0-01,0,0-01,0,0-01,2,0-01,2,0-01,0,0-01,0,0-01,0,0-01,0,0-01,0,0-01,0,0-01,0,0-01,0,0-01,0,0-01,0,0-01,0,0-01,0,0-01,0,0-01,0,0-01,0,0-01,0,0-01,0,0-01,0,0-01,0,0-02,0,0
02,0,0-02,0,0-02,0,0-02,0,0-02,0,0-02,0,0-02,0,0-02,0,0-02,0,0-02,0,0-02,0,0-02,0,0-02,0,0-02,0,0-02,0,0-02,0,0-02,0,0-02,0,0-02,0,0-02,0,0-02,0,0-02,0,0-02,0,0-02,0,0-02,0,0-02,0,0-02,0,0-02,0,0-02,0,0-02,0,0