00,0,0-01,4,0-01,0,0-00,0,0-00,0,0-01,0,0-01,0,0-00,0,0
00,0,0-01,3,0-01,0,0-00,0,0-00,0,0-00,0,0-01,0,0-00,0,0
01,0,0-01,2,0-01,0,0-00,0,0-01,0,0-01,0,0-01,0,0-00,0,0
02,0,0-01,1,0-01,0,0-02,0,0-00,0,0-01,0,0-01,0,0-01,1,0
02,0,0-02,0,0-01,0,0-02,0,0-00,0,0-01,0,0-01,0,0-01,2,0
00,0,0-02,0,0-01,0,0-02,0,0-00,0,0-01,0,0-01,0,0-01,3,0
02,0,0-00,0,0-01,0,0-01,0,0-00,1,0-01,0,0-01,0,0-01,4,0
02,0,0-01,0,0-00,0,0-01,0,0-00,1,0-01,0,0-01,0,0-01,5,0