02,0,0-02,0,0-02,0,0-02,0,0-02,0,0-02,0,0-02,0,0-02,0,0-02,0,0-02,0,0-02,0,0-02,0,0-02,0,0-02,0,0-02,0,0-02,0,0-02,0,0-02,0,0-02,0,0-02,0,0-02,0,0-02,0,0-02,0,0-02,0,0-02,0,0-02,0,0-02,0,0-02,0,0-02,0,0-02,0,0-02,0,0-02,0,0-02,0,0-02,0,0-02,0,0
02,0,0-01,0,0-01,0,0-01,0,0-01,0,0-01,0,0-01,0,0-01,0,0-01,0,0-01,0,0-01,0,0-01,0,0-01,0,0-01,0,0-01,0,0-01,0,0-01,0,0-01,0,0-01,0,0-01,0,0-01,0,0-01,0,0-01,0,0-01,0,0-01,0,0-01,0,0-01,0,0-01,0,0-01,0,0-01,0,0-01,0,0-01,0,0-01,0,0-01,0,0-02,0,0
02,0,0-01,0,0-01,0,0-01,0,0-01,0,0-01,0,0-01,0,0-01,0,0-01,0,0-01,0,0-01,0,0-01,0,0-01,0,0-01,0,0-01,0,0-01,0,0-01,0,0-01,0,0-01,0,0-01,0,0-01,0,0-01,0,0-01,0,0-01,0,0-01,0,0-01,0,0-01,0,0-01,0,0-01,0,0-01,0,0-01,0,0-01,0,0-01,0,0-01,0,0-02,0,0
02,0,0-01,0,0-01,0,0-01,0,0-01,0,0-01,0,0-01,0,0-01,0,0-01,0,0-01,0,0-01,0,0-01,0,0-01,0,0-01,0,0-01,0,0-01,0,0-01,0,0-01,0,0-01,0,0-01,0,0-01,0,0-01,0,0-01,0,0-01,0,0-01,0,0-01,0,0-01,0,0-01,0,0-01,0,0-01,0,0-01,0,0-01,0,0-01,0,0-01,0,0-02,0,0
02,0,0-01,0,0-01,0,0-01,0,0-01,0,0-01,0,0-01,0,0-01,0,0-01,0,0-01,0,0-01,0,0-01,0,0-01,0,0-01,0,0-01,0,0-01,0,0-01,0,0-01,0,0-01,0,0-01,0,0-01,0,0-01,0,0-01,0,0-01,0,0-01,0,0-01,0,0-01,0,0-01,0,0-01,0,0-01,0,0-01,0,0-01,0,0-01,0,0-01,0,0-02,0,0
02,0,0-01,0,0-01,0,0-01,0,0-01,0,0-01,0,0-01,0,0-01,0,0-01,0,0-01,0,0-01,0,0-01,0,0-01,0,0-01,0,0-01,0,0-01,0,0-01,0,0-01,0,0-01,0,0-01,0,0-01,0,0-01,0,0-01,0,0-01,0,0-01,0,0-01,0,0-01,0,0-01,0,0-01,0,0-01,0,0-01,0,0-01,0,0-01,0,0-01,0,0-02,0,0
02,0,0-01,0,0-01,0,0-01,0,0-01,0,0-01,0,0-01,0,0-01,0,0-01,0,0-01,0,0-01,0,0-01,0,0-01,0,0-01,0,0-01,0,0-01,0,0-01,0,0-01,0,0-01,0,0-01,0,0-01,0,0-01,0,0-01,0,0-01,0,0-01,0,0-01,0,0-01,0,0-01,0,0-01,0,0-01,0,0-01,0,0-01,0,0-01,0,0-01,0,0-02,0,0
02,0,0-01,0,0-01,0,0-01,0,0-01,0,0-01,0,0-01,0,0-01,0,0-01,0,0-01,0,0-01,0,0-01,0,0-01,0,0-01,0,0-01,0,0-01,0,0-01,0,0-01,0,0-01,0,0-01,0,0-01,0,0-01,0,0-01,0,0-01,0,0-01,0,0-01,0,0-01,0,0-01,0,0-01,0,0-01,0,0-01,0,0-01,0,0-01,0,0-01,0,0-02,0,0
02,0,0-01,0,0-01,0,0-01,0,0-01,0,0-01,0,0-01,0,0-01,0,0-01,0,0-01,0,0-01,0,0-01,0,0-01,0,0-01,0,0-01,0,0-01,0,0-01,0,0-01,0,0-01,0,0-01,0,0-01,0,0-01,0,0-01,0,0-01,0,0-01,0,0-01,0,0-01,0,0-01,0,0-01,0,0-01,0,0-01,0,0-01,0,0-01,0,0-01,0,0-02,0,0
02,0,0-01,0,0-01,0,0-01,0,0-01,0,0-01,0,0-01,0,0-01,0,0-01,0,0-01,0,0-01,0,0-01,0,0-01,0,0-01,0,0-01,0,0-01,0,0-01,0,0-01,0,0-01,0,0-01,0,0-01,0,0-01,0,0-01,0,0-01,0,0-01,0,0-01,0,0-01,0,0-01,0,0-01,0,0-01,0,0-01,0,0-01,0,0-01,0,0-01,0,0-02,0,0
02,0,0-01,0,0-01,0,0-01,0,0-01,0,0-01,0,0-01,0,0-01,0,0-01,0,0-01,0,0-01,0,0-01,0,0-01,0,0-01,0,0-01,0,0-01,0,0-01,0,0-01,0,0-01,0,0-01,0,0-01,0,0-01,0,0-01,0,0-01,0,0-01,0,0-01,0,0-01,0,0-01,0,0-01,0,0-01,0,0-01,0,0-01,0,0-01,0,0-01,0,0-02,0,0
02,0,0-01,0,0-01,0,0-01,0,0-01,0,0-01,0,0-01,0,0-01,0,0-01,0,0-01,0,0-01,0,0-01,0,0-01,0,0-01,0,0-01,0,0-01,0,0-01,0,0-01,0,0-01,0,0-01,0,0-01,0,0-01,0,0-01,0,0-01,0,0-01,0,0-01,0,0-01,0,0-01,0,0-01,0,0-01,0,0-01,0,0-01,0,0-01,0,0-01,0,0-02,0,0
02,0,0-01,0,0-01,0,0-01,0,0-01,0,0-01,0,0-01,0,0-01,0,0-01,0,0-01,0,0-01,0,0-01,0,0-01,0,0-01,0,0-01,0,0-01,0,0-01,0,0-01,0,0-01,0,0-01,0,0-01,0,0-01,0,0-01,0,0-01,0,0-01,0,0-01,0,0-01,0,0-01,0,0-01,0,0-01,0,0-01,0,0-01,0,0-01,0,0-01,0,0-02,0,0
02,0,0-01,0,0-01,0,0-01,0,0-01,0,0-01,0,0-01,0,0-01,0,0-01,0,0-01,0,0-01,0,0-01,0,0-01,0,0-01,0,0-01,0,0-01,0,0-01,0,0-01,0,0-01,0,0-01,0,0-01,0,0-01,0,0-01,0,0-01,0,0-01,0,0-01,0,0-01,0,0-01,0,0-01,0,0-01,0,0-01,0,0-01,0,0-01,0,0-01,0,0-02,0,0
02,0,0-01,0,0-01,0,0-01,0,0-01,0,0-01,0,0-01,0,0-01,0,0-01,0,0-01,0,0-01,0,0-01,0,0-01,0,0-01,0,0-01,0,0-01,0,0-01,0,0-01,0,0-01,0,0-01,0,0-01,0,0-01,0,0-01,0,0-01,0,0-01,0,0-01,0,0-01,0,0-01,0,0-01,0,0-01,0,0-01,0,0-01,0,0-01,0,0-01,0,0-02,0,0
02,0,0-01,0,0-01,0,0-01,0,0-01,0,0-01,0,0-01,0,0-01,0,0-01,0,0-01,0,0-01,0,0-01,0,0-01,0,0-01,0,0-01,0,0-01,0,0-01,0,0-01,0,0-01,0,0-01,0,0-01,0,0-01,0,0-01,0,0-01,0,0-01,0,0-01,0,0-01,0,0-01,0,0-01,0,0-01,0,0-01,0,0-01,0,0-01,0,0-01,0,0-02,0,0
02,0,0-01,0,0-01,0,0-01,0,0-01,0,0-01,0,0-01,0,0-01,0,0-01,0,0-01,0,0-01,0,0-01,0,0-01,0,0-01,0,0-01,0,0-01,0,0-01,0,0-01,0,0-01,0,0-01,0,0-01,0,0-01,0,0-01,0,0-01,0,0-01,0,0-01,0,0-01,0,0-01,0,0-01,0,0-01,0,0-01,0,0-01,0,0-01,0,0-01,0,0-02,0,0
02,0,0-01,0,0-01,0,0-01,0,0-01,0,0-01,0,0-01,0,0-01,0,0-01,0,0-01,0,0-01,0,0-01,0,0-01,0,0-01,0,0-01,0,0-01,0,0-01,0,0-01,0,0-01,0,0-01,0,0-01,0,0-01,0,0-01,0,0-01,0,0-01,0,0-01,0,0-01,0,0-01,0,0-01,0,0-01,0,0-01,0,0-01,0,0-01,0,0-01,0,0-02,0,0
02,0,0-01,0,0-01,0,0-01,0,0-01,0,0-01,0,0-01,0,0-01,0,0-01,0,0-01,0,0-01,0,0-01,0,0-01,0,0-01,0,0-01,0,0-01,0,0-01,0,0-01,0,0-01,0,0-01,0,0-01,0,0-01,0,0-01,0,0-01,0,0-01,0,0-01,0,0-01,0,0-01,0,0-01,0,0-01,0,0-01,0,0-01,0,0-01,0,0-01,0,0-02,0,0
02,0,0-01,0,0-01,0,0-01,0,0-01,0,0-01,0,0-01,0,0-01,0,0-01,0,0-01,0,0-01,0,0-01,0,0-01,0,0-01,0,0-01,0,0-01,0,0-01,0,0-01,0,0-01,0,0-01,0,0-01,0,0-01,0,0-01,0,0-01,0,0-01,0,0-01,0,0-01,0,0-01,0,0-01,0,0-01,0,0-01,0,0-01,0,0-01,0,0-01,0,0-02,0,0
02,0,0-01,0,0-01,0,0-01,0,0-01,0,0-01,0,0-01,0,0-01,0,0-01,0,0-01,0,0-01,0,0-01,0,0-01,0,0-01,0,0-01,0,0-01,0,0-01,0,0-01,0,0-01,0,0-01,0,0-01,0,0-01,0,0-01,0,0-01,0,0-01,0,0-01,0,0-01,0,0-01,0,0-01,0,0-01,0,0-01,0,0-01,0,0-01,0,0-01,0,0-02,0,0
02,0,0-01,0,0-01,0,0-01,0,0-01,0,0-01,0,0-01,0,0-01,0,0-01,0,0-01,0,0-01,0,0-01,0,0-01,0,0-01,0,0-01,0,0-01,0,0-01,0,0-01,0,0-01,0,0-01,0,0-01,0,0-01,0,0-01,0,0-01,0,0-01,0,0-01,0,0-01,0,0-01,0,0-01,0,0-01,0,0-01,0,0-01,0,0-01,0,0-01,0,0-02,0,0
02,0,0-01,0,0-01,0,0-01,2,0-01,0,0-01,0,0-01,0,0-01,0,0-01,0,0-01,0,0-01,0,0-01,0,0-01,0,0-01,0,0-01,0,0-01,0,0-01,0,0-01,0,0-01,0,0-01,0,0-01,0,0-01,0,0-01,0,0-01,0,0-01,0,0-01,0,0-01,0,0-01,0,0-01,0,0-01,0,0-01,0,0-01,0,0-01,0,0-01,0,0-02,0,0
02,0,0-01,0,0-01,0,0-01,0,0-01,0,0-01,0,0-01,0,0-01,0,0-01,0,0-01,0,0-01,0,0-01,0,0-01,0,0-01,0,0-01,0,0-01,0,0-01,0,0-01,0,0-01,0,0-01,0,0-01,0,0-01,0,0-01,0,0-01,0,0-01,0,0-01,0,0-01,0,0-01,0,0-01,0,0-01,0,0-01,0,0-01,0,0-01,0,0-01,0,0-02,0,0
02,0,0-01,0,0-01,0,0-01,0,0-01,0,0-01,0,0-01,0,0-01,0,0-01,0,0-01,0,0-01,0,0-01,0,0-01,0,0-01,0,0-01,0,0-01,0,0-01,0,0-01,0,0-01,0,0-01,0,0-01,0,0-01,0,0-01,0,0-01,0,0-01,0,0-01,0,0-01,0,0-01,0,0-01,0,0-01,0,0-01,0,0-01,0,0-01,0,0-01,0,0-02,0,0
02,0,0-01,0,0-01,0,0-01,0,0-01,0,0-01,0,0-01,0,0-01,0,0-01,0,0-01,0,0-01,0,0-01,0,0-01,0,0-01,0,0-01,0,0-01,0,0-01,0,0-01,0,0-01,0,0-01,0,0-01,0,0-01,0,0-01,0,0-01,0,0-01,0,0-01,0,0-01,0,0-01,0,0-01,0,0-01,0,0-01,0,0-01,0,0-01,0,0-01,0,0-02,0,0
02,0,0-01,0,0-01,0,0-01,0,0-01,0,0-01,0,0-01,0,0-01,0,0-01,0,0-01,0,0-01,0,0-01,0,0-01,0,0-01,0,0-01,0,0-01,0,0-01,0,0-01,0,0-01,0,0-01,0,0-01,0,0-01,0,0-01,0,0-01,0,0-01,0,0-01,0,0-01,0,0-01,0,0-01,0,0-01,0,0-01,0,0-01,0,0-01,0,0-01,0,0-02,0,0
02,0,0-01,0,0-01,0,0-01,0,0-01,0,0-01,0,0-01,0,0-01,0,0-01,0,0-01,0,0-01,0,0-01,0,0-01,0,0-01,0,0-01,0,0-01,0,0-01,0,0-01,0,0-01,0,0-01,0,0-01,0,0-01,0,0-01,0,0-01,0,0-01,0,0-01,0,0-01,0,0-01,0,0-01,0,0-01,0,0-01,0,0-01,0,0-01,0,0-01,0,0-02,0,0
02,0,0-01,0,0-01,0,0-01,0,0-01,0,0-01,0,0-01,0,0-01,0,0-01,0,0-01,0,0-01,0,0-01,0,0-01,0,0-01,0,0-01,0,0-01,0,0-01,0,0-01,0,0-01,0,0-01,0,0-01,0,0-01,0,0-01,0,0-01,0,0-01,0,0-01,0,0-01,0,0-01,0,0-01,0,0-01,0,0-01,0,0-01,0,0-01,0,0-01,0,0-02,0,0
02,0,0-01,0,0-01,0,0-01,0,0-01,0,0-01,0,0-01,0,0-01,0,0-01,0,0-01,0,0-01,0,0-01,0,0-01,0,0-01,0,0-01,0,0-01,0,0-01,0,0-01,0,0-01,0,0-01,0,0-01,0,0-01,0,0-01,0,0-01,0,0-01,0,0-01,0,0-01,0,0-01,0,0-01,0,0-01,0,0-01,0,0-01,0,0-01,0,0-01,0,0-02,0,0
02,0,0-01,0,0-01,0,0-01,0,0-01,0,0-01,0,0-01,0,0-01,0,0-01,0,0-01,0,0-01,0,0-01,0,0-01,0,0-01,0,0-01,0,0-01,0,0-01,0,0-01,0,0-01,0,0-01,0,0-01,0,0-01,0,0-01,0,0-01,0,0-01,0,0-01,0,0-01,0,0-01,0,0-01,0,0-01,0,0-01,0,0-01,0,0-01,0,0-01,0,0-02,0,0
02,0,0-01,0,0-01,0,0-01,0,0-01,0,0-01,0,0-01,0,0-01,0,0-01,0,0-01,0,0-01,0,0-01,0,0-01,0,0-01,0,0-01,0,0-01,0,0-01,0,0-01,0,0-01,0,0-01,0,0-01,0,0-01,0,0-01,0,0-01,0,0-01,0,0-01,0,0-01,0,0-01,0,0-01,0,0-01,0,0-01,0,0-01,0,0-01,0,0-01,0,0-02,0,0
02,0,0-01,0,0-01,0,0-01,0,0-01,0,0-01,0,0-01,0,0-01,0,0-01,0,0-01,0,0-01,0,0-01,0,0-01,0,0-01,0,0-01,0,0-01,0,0-01,0,0-01,0,0-01,0,0-01,0,0-01,0,0-01,0,0-01,0,0-01,0,0-01,0,0-01,0,0-01,0,0-01,0,0-01,0,0-01,0,0-01,0,0-01,0,0-01,0,0-01,0,0-02,0,0
02,0,0-01,0,0-01,0,0-01,0,0-01,0,0-01,0,0-01,0,0-01,0,0-01,0,0-01,0,0-01,0,0-01,0,0-01,0,0-01,0,0-01,0,0-01,0,0-01,0,0-01,0,0-01,0,0-01,0,0-01,0,0-01,0,0-01,0,0-01,0,0-01,0,0-01,0,0-01,0,0-01,0,0-01,0,0-01,0,0-01,0,0-01,0,0-01,0,0-01,0,0-02,0,0
02,0,0-02,0,0-02,0,0-02,0,0-02,0,0-02,0,0-02,0,0-02,0,0-02,0,0-02,0,0-02,0,0-02,0,0-02,0,0-02,0,0-02,0,0-02,0,0-02,0,0-02,0,0-02,0,0-02,0,0-02,0,0-02,0,0-02,0,0-02,0,0-02,0,0-02,0,0-02,0,0-02,0,0-02,0,0-02,0,0-02,0,0-02,0,0-02,0,0-02,0,0-02,0,0